"filename", "language", "Markdown", "Java", "XML", "SQL", "comment", "blank", "total"
"d:\Trabajos\PWC\Test-tecnico-Java\README.md", "Markdown", 50, 0, 0, 0, 0, 24, 74
"d:\Trabajos\PWC\Test-tecnico-Java\TestTecnico\pom.xml", "XML", 0, 0, 73, 0, 2, 2, 77
"d:\Trabajos\PWC\Test-tecnico-Java\TestTecnico\src\main\java\com\mycompany\testtecnico\TestTecnico.java", "Java", 0, 12, 0, 0, 17, 14, 43
"d:\Trabajos\PWC\Test-tecnico-Java\TestTecnico\src\main\java\com\mycompany\testtecnico\igu\CourseEdit.java", "Java", 0, 151, 0, 0, 15, 29, 195
"d:\Trabajos\PWC\Test-tecnico-Java\TestTecnico\src\main\java\com\mycompany\testtecnico\igu\CoursePanel.java", "Java", 0, 250, 0, 0, 20, 41, 311
"d:\Trabajos\PWC\Test-tecnico-Java\TestTecnico\src\main\java\com\mycompany\testtecnico\igu\DepartmentEdit.java", "Java", 0, 131, 0, 0, 20, 32, 183
"d:\Trabajos\PWC\Test-tecnico-Java\TestTecnico\src\main\java\com\mycompany\testtecnico\igu\DepartmentPanel.java", "Java", 0, 221, 0, 0, 23, 41, 285
"d:\Trabajos\PWC\Test-tecnico-Java\TestTecnico\src\main\java\com\mycompany\testtecnico\igu\IguCommodities.java", "Java", 0, 105, 0, 0, 11, 35, 151
"d:\Trabajos\PWC\Test-tecnico-Java\TestTecnico\src\main\java\com\mycompany\testtecnico\igu\SectionEdit.java", "Java", 0, 136, 0, 0, 15, 35, 186
"d:\Trabajos\PWC\Test-tecnico-Java\TestTecnico\src\main\java\com\mycompany\testtecnico\igu\SectionPanel.java", "Java", 0, 231, 0, 0, 15, 44, 290
"d:\Trabajos\PWC\Test-tecnico-Java\TestTecnico\src\main\java\com\mycompany\testtecnico\igu\StaffPanel.java", "Java", 0, 116, 0, 0, 22, 21, 159
"d:\Trabajos\PWC\Test-tecnico-Java\TestTecnico\src\main\java\com\mycompany\testtecnico\igu\StartPanel.java", "Java", 0, 167, 0, 0, 23, 29, 219
"d:\Trabajos\PWC\Test-tecnico-Java\TestTecnico\src\main\java\com\mycompany\testtecnico\igu\StudentEdit.java", "Java", 0, 324, 0, 0, 20, 51, 395
"d:\Trabajos\PWC\Test-tecnico-Java\TestTecnico\src\main\java\com\mycompany\testtecnico\igu\StudentPanel.java", "Java", 0, 295, 0, 0, 20, 48, 363
"d:\Trabajos\PWC\Test-tecnico-Java\TestTecnico\src\main\java\com\mycompany\testtecnico\igu\TeacherEdit.java", "Java", 0, 283, 0, 0, 20, 51, 354
"d:\Trabajos\PWC\Test-tecnico-Java\TestTecnico\src\main\java\com\mycompany\testtecnico\igu\TeacherPanel.java", "Java", 0, 320, 0, 0, 24, 53, 397
"d:\Trabajos\PWC\Test-tecnico-Java\TestTecnico\src\main\java\com\mycompany\testtecnico\igu\WatchmanEdit.java", "Java", 0, 283, 0, 0, 19, 55, 357
"d:\Trabajos\PWC\Test-tecnico-Java\TestTecnico\src\main\java\com\mycompany\testtecnico\igu\WatchmanPanel.java", "Java", 0, 327, 0, 0, 26, 53, 406
"d:\Trabajos\PWC\Test-tecnico-Java\TestTecnico\src\main\java\com\mycompany\testtecnico\logic\CivilStatus.java", "Java", 0, 44, 0, 0, 8, 15, 67
"d:\Trabajos\PWC\Test-tecnico-Java\TestTecnico\src\main\java\com\mycompany\testtecnico\logic\Controller.java", "Java", 0, 266, 0, 0, 13, 126, 405
"d:\Trabajos\PWC\Test-tecnico-Java\TestTecnico\src\main\java\com\mycompany\testtecnico\logic\Course.java", "Java", 0, 45, 0, 0, 8, 18, 71
"d:\Trabajos\PWC\Test-tecnico-Java\TestTecnico\src\main\java\com\mycompany\testtecnico\logic\CourseAndStudent.java", "Java", 0, 53, 0, 0, 8, 18, 79
"d:\Trabajos\PWC\Test-tecnico-Java\TestTecnico\src\main\java\com\mycompany\testtecnico\logic\Department.java", "Java", 0, 57, 0, 0, 8, 13, 78
"d:\Trabajos\PWC\Test-tecnico-Java\TestTecnico\src\main\java\com\mycompany\testtecnico\logic\Person.java", "Java", 0, 52, 0, 0, 8, 17, 77
"d:\Trabajos\PWC\Test-tecnico-Java\TestTecnico\src\main\java\com\mycompany\testtecnico\logic\Section.java", "Java", 0, 68, 0, 0, 8, 15, 91
"d:\Trabajos\PWC\Test-tecnico-Java\TestTecnico\src\main\java\com\mycompany\testtecnico\logic\Servicestaff.java", "Java", 0, 53, 0, 0, 8, 16, 77
"d:\Trabajos\PWC\Test-tecnico-Java\TestTecnico\src\main\java\com\mycompany\testtecnico\logic\Staff.java", "Java", 0, 36, 0, 0, 8, 11, 55
"d:\Trabajos\PWC\Test-tecnico-Java\TestTecnico\src\main\java\com\mycompany\testtecnico\logic\Student.java", "Java", 0, 16, 0, 0, 9, 14, 39
"d:\Trabajos\PWC\Test-tecnico-Java\TestTecnico\src\main\java\com\mycompany\testtecnico\logic\Teacher.java", "Java", 0, 52, 0, 0, 8, 15, 75
"d:\Trabajos\PWC\Test-tecnico-Java\TestTecnico\src\main\java\com\mycompany\testtecnico\persistence\CourseController.java", "Java", 0, 67, 0, 0, 8, 42, 117
"d:\Trabajos\PWC\Test-tecnico-Java\TestTecnico\src\main\java\com\mycompany\testtecnico\persistence\CoursesAndStudentsController.java", "Java", 0, 66, 0, 0, 8, 31, 105
"d:\Trabajos\PWC\Test-tecnico-Java\TestTecnico\src\main\java\com\mycompany\testtecnico\persistence\DBConection.java", "Java", 0, 145, 0, 0, 43, 37, 225
"d:\Trabajos\PWC\Test-tecnico-Java\TestTecnico\src\main\java\com\mycompany\testtecnico\persistence\DepartmentController.java", "Java", 0, 71, 0, 0, 8, 35, 114
"d:\Trabajos\PWC\Test-tecnico-Java\TestTecnico\src\main\java\com\mycompany\testtecnico\persistence\PersistenceController.java", "Java", 0, 262, 0, 0, 8, 80, 350
"d:\Trabajos\PWC\Test-tecnico-Java\TestTecnico\src\main\java\com\mycompany\testtecnico\persistence\PersistenceIdObjects.java", "Java", 0, 121, 0, 0, 10, 39, 170
"d:\Trabajos\PWC\Test-tecnico-Java\TestTecnico\src\main\java\com\mycompany\testtecnico\persistence\PersistenceService.java", "Java", 0, 10, 0, 0, 8, 6, 24
"d:\Trabajos\PWC\Test-tecnico-Java\TestTecnico\src\main\java\com\mycompany\testtecnico\persistence\SectionController.java", "Java", 0, 70, 0, 0, 8, 38, 116
"d:\Trabajos\PWC\Test-tecnico-Java\TestTecnico\src\main\java\com\mycompany\testtecnico\persistence\ServicestaffController.java", "Java", 0, 187, 0, 0, 18, 57, 262
"d:\Trabajos\PWC\Test-tecnico-Java\TestTecnico\src\main\java\com\mycompany\testtecnico\persistence\StaffController.java", "Java", 0, 6, 0, 0, 8, 6, 20
"d:\Trabajos\PWC\Test-tecnico-Java\TestTecnico\src\main\java\com\mycompany\testtecnico\persistence\StudentController.java", "Java", 0, 77, 0, 0, 8, 36, 121
"d:\Trabajos\PWC\Test-tecnico-Java\TestTecnico\src\main\java\com\mycompany\testtecnico\persistence\TeacherController.java", "Java", 0, 189, 0, 0, 18, 56, 263
"d:\Trabajos\PWC\Test-tecnico-Java\TestTecnico\src\main\java\com\mycompany\testtecnico\persistence\exceptions\IllegalOrphanException.java", "Java", 0, 18, 0, 0, 0, 3, 21
"d:\Trabajos\PWC\Test-tecnico-Java\TestTecnico\src\main\java\com\mycompany\testtecnico\persistence\exceptions\NonexistentEntityException.java", "Java", 0, 9, 0, 0, 0, 2, 11
"d:\Trabajos\PWC\Test-tecnico-Java\TestTecnico\src\main\java\com\mycompany\testtecnico\persistence\exceptions\PreexistingEntityException.java", "Java", 0, 9, 0, 0, 0, 2, 11
"d:\Trabajos\PWC\Test-tecnico-Java\TestTecnico\src\main\resources\META-INF\persistence.xml", "XML", 0, 0, 24, 0, 0, 1, 25
"d:\Trabajos\PWC\Test-tecnico-Java\TestTecnico\target\classes\META-INF\persistence.xml", "XML", 0, 0, 24, 0, 0, 1, 25
"d:\Trabajos\PWC\Test-tecnico-Java\TestTecnico\target\classes\com\mycompany\testtecnico\TestTecnico.class", "Java", 0, 12, 0, 0, 0, 0, 12
"d:\Trabajos\PWC\Test-tecnico-Java\TestTecnico\target\classes\com\mycompany\testtecnico\igu\CourseEdit$1.class", "Java", 0, 11, 0, 0, 0, 0, 11
"d:\Trabajos\PWC\Test-tecnico-Java\TestTecnico\target\classes\com\mycompany\testtecnico\igu\CourseEdit$2.class", "Java", 0, 11, 0, 0, 0, 0, 11
"d:\Trabajos\PWC\Test-tecnico-Java\TestTecnico\target\classes\com\mycompany\testtecnico\igu\CourseEdit$3.class", "Java", 0, 11, 0, 0, 0, 0, 11
"d:\Trabajos\PWC\Test-tecnico-Java\TestTecnico\target\classes\com\mycompany\testtecnico\igu\CourseEdit$4.class", "Java", 0, 11, 0, 0, 0, 0, 11
"d:\Trabajos\PWC\Test-tecnico-Java\TestTecnico\target\classes\com\mycompany\testtecnico\igu\CourseEdit.class", "Java", 0, 72, 0, 0, 0, 0, 72
"d:\Trabajos\PWC\Test-tecnico-Java\TestTecnico\target\classes\com\mycompany\testtecnico\igu\CoursePanel$1.class", "Java", 0, 8, 0, 0, 0, 0, 8
"d:\Trabajos\PWC\Test-tecnico-Java\TestTecnico\target\classes\com\mycompany\testtecnico\igu\CoursePanel$2.class", "Java", 0, 11, 0, 0, 0, 0, 11
"d:\Trabajos\PWC\Test-tecnico-Java\TestTecnico\target\classes\com\mycompany\testtecnico\igu\CoursePanel$3.class", "Java", 0, 11, 0, 0, 0, 0, 11
"d:\Trabajos\PWC\Test-tecnico-Java\TestTecnico\target\classes\com\mycompany\testtecnico\igu\CoursePanel$4.class", "Java", 0, 11, 0, 0, 0, 0, 11
"d:\Trabajos\PWC\Test-tecnico-Java\TestTecnico\target\classes\com\mycompany\testtecnico\igu\CoursePanel$5.class", "Java", 0, 11, 0, 0, 0, 0, 11
"d:\Trabajos\PWC\Test-tecnico-Java\TestTecnico\target\classes\com\mycompany\testtecnico\igu\CoursePanel.class", "Java", 0, 97, 0, 0, 0, 0, 97
"d:\Trabajos\PWC\Test-tecnico-Java\TestTecnico\target\classes\com\mycompany\testtecnico\igu\DepartmentEdit$1.class", "Java", 0, 11, 0, 0, 0, 0, 11
"d:\Trabajos\PWC\Test-tecnico-Java\TestTecnico\target\classes\com\mycompany\testtecnico\igu\DepartmentEdit$2.class", "Java", 0, 11, 0, 0, 0, 0, 11
"d:\Trabajos\PWC\Test-tecnico-Java\TestTecnico\target\classes\com\mycompany\testtecnico\igu\DepartmentEdit$3.class", "Java", 0, 11, 0, 0, 0, 0, 11
"d:\Trabajos\PWC\Test-tecnico-Java\TestTecnico\target\classes\com\mycompany\testtecnico\igu\DepartmentEdit$4.class", "Java", 0, 11, 0, 0, 0, 0, 11
"d:\Trabajos\PWC\Test-tecnico-Java\TestTecnico\target\classes\com\mycompany\testtecnico\igu\DepartmentEdit.class", "Java", 0, 57, 0, 0, 0, 0, 57
"d:\Trabajos\PWC\Test-tecnico-Java\TestTecnico\target\classes\com\mycompany\testtecnico\igu\DepartmentPanel$1.class", "Java", 0, 8, 0, 0, 0, 0, 8
"d:\Trabajos\PWC\Test-tecnico-Java\TestTecnico\target\classes\com\mycompany\testtecnico\igu\DepartmentPanel$2.class", "Java", 0, 11, 0, 0, 0, 0, 11
"d:\Trabajos\PWC\Test-tecnico-Java\TestTecnico\target\classes\com\mycompany\testtecnico\igu\DepartmentPanel$3.class", "Java", 0, 11, 0, 0, 0, 0, 11
"d:\Trabajos\PWC\Test-tecnico-Java\TestTecnico\target\classes\com\mycompany\testtecnico\igu\DepartmentPanel$4.class", "Java", 0, 11, 0, 0, 0, 0, 11
"d:\Trabajos\PWC\Test-tecnico-Java\TestTecnico\target\classes\com\mycompany\testtecnico\igu\DepartmentPanel$5.class", "Java", 0, 11, 0, 0, 0, 0, 11
"d:\Trabajos\PWC\Test-tecnico-Java\TestTecnico\target\classes\com\mycompany\testtecnico\igu\DepartmentPanel.class", "Java", 0, 86, 0, 0, 0, 0, 86
"d:\Trabajos\PWC\Test-tecnico-Java\TestTecnico\target\classes\com\mycompany\testtecnico\igu\IguCommodities.class", "Java", 0, 57, 0, 0, 0, 2, 59
"d:\Trabajos\PWC\Test-tecnico-Java\TestTecnico\target\classes\com\mycompany\testtecnico\igu\SectionEdit$1.class", "Java", 0, 11, 0, 0, 0, 0, 11
"d:\Trabajos\PWC\Test-tecnico-Java\TestTecnico\target\classes\com\mycompany\testtecnico\igu\SectionEdit$2.class", "Java", 0, 11, 0, 0, 0, 0, 11
"d:\Trabajos\PWC\Test-tecnico-Java\TestTecnico\target\classes\com\mycompany\testtecnico\igu\SectionEdit$3.class", "Java", 0, 11, 0, 0, 0, 0, 11
"d:\Trabajos\PWC\Test-tecnico-Java\TestTecnico\target\classes\com\mycompany\testtecnico\igu\SectionEdit$4.class", "Java", 0, 11, 0, 0, 0, 0, 11
"d:\Trabajos\PWC\Test-tecnico-Java\TestTecnico\target\classes\com\mycompany\testtecnico\igu\SectionEdit$5.class", "Java", 0, 11, 0, 0, 0, 0, 11
"d:\Trabajos\PWC\Test-tecnico-Java\TestTecnico\target\classes\com\mycompany\testtecnico\igu\SectionEdit.class", "Java", 0, 61, 0, 0, 0, 0, 61
"d:\Trabajos\PWC\Test-tecnico-Java\TestTecnico\target\classes\com\mycompany\testtecnico\igu\SectionPanel$1.class", "Java", 0, 8, 0, 0, 0, 0, 8
"d:\Trabajos\PWC\Test-tecnico-Java\TestTecnico\target\classes\com\mycompany\testtecnico\igu\SectionPanel$2.class", "Java", 0, 11, 0, 0, 0, 0, 11
"d:\Trabajos\PWC\Test-tecnico-Java\TestTecnico\target\classes\com\mycompany\testtecnico\igu\SectionPanel$3.class", "Java", 0, 11, 0, 0, 0, 0, 11
"d:\Trabajos\PWC\Test-tecnico-Java\TestTecnico\target\classes\com\mycompany\testtecnico\igu\SectionPanel$4.class", "Java", 0, 11, 0, 0, 0, 0, 11
"d:\Trabajos\PWC\Test-tecnico-Java\TestTecnico\target\classes\com\mycompany\testtecnico\igu\SectionPanel$5.class", "Java", 0, 11, 0, 0, 0, 0, 11
"d:\Trabajos\PWC\Test-tecnico-Java\TestTecnico\target\classes\com\mycompany\testtecnico\igu\SectionPanel.class", "Java", 0, 96, 0, 0, 0, 0, 96
"d:\Trabajos\PWC\Test-tecnico-Java\TestTecnico\target\classes\com\mycompany\testtecnico\igu\StaffPanel$1.class", "Java", 0, 11, 0, 0, 0, 0, 11
"d:\Trabajos\PWC\Test-tecnico-Java\TestTecnico\target\classes\com\mycompany\testtecnico\igu\StaffPanel$2.class", "Java", 0, 11, 0, 0, 0, 0, 11
"d:\Trabajos\PWC\Test-tecnico-Java\TestTecnico\target\classes\com\mycompany\testtecnico\igu\StaffPanel$3.class", "Java", 0, 11, 0, 0, 0, 0, 11
"d:\Trabajos\PWC\Test-tecnico-Java\TestTecnico\target\classes\com\mycompany\testtecnico\igu\StaffPanel.class", "Java", 0, 57, 0, 0, 0, 0, 57
"d:\Trabajos\PWC\Test-tecnico-Java\TestTecnico\target\classes\com\mycompany\testtecnico\igu\StartPanel$1.class", "Java", 0, 11, 0, 0, 0, 0, 11
"d:\Trabajos\PWC\Test-tecnico-Java\TestTecnico\target\classes\com\mycompany\testtecnico\igu\StartPanel$2.class", "Java", 0, 11, 0, 0, 0, 0, 11
"d:\Trabajos\PWC\Test-tecnico-Java\TestTecnico\target\classes\com\mycompany\testtecnico\igu\StartPanel$3.class", "Java", 0, 11, 0, 0, 0, 0, 11
"d:\Trabajos\PWC\Test-tecnico-Java\TestTecnico\target\classes\com\mycompany\testtecnico\igu\StartPanel$4.class", "Java", 0, 11, 0, 0, 0, 0, 11
"d:\Trabajos\PWC\Test-tecnico-Java\TestTecnico\target\classes\com\mycompany\testtecnico\igu\StartPanel$5.class", "Java", 0, 11, 0, 0, 0, 0, 11
"d:\Trabajos\PWC\Test-tecnico-Java\TestTecnico\target\classes\com\mycompany\testtecnico\igu\StartPanel$6.class", "Java", 0, 11, 0, 0, 0, 0, 11
"d:\Trabajos\PWC\Test-tecnico-Java\TestTecnico\target\classes\com\mycompany\testtecnico\igu\StartPanel.class", "Java", 0, 69, 0, 0, 0, 0, 69
"d:\Trabajos\PWC\Test-tecnico-Java\TestTecnico\target\classes\com\mycompany\testtecnico\igu\StudentEdit$1.class", "Java", 0, 11, 0, 0, 0, 0, 11
"d:\Trabajos\PWC\Test-tecnico-Java\TestTecnico\target\classes\com\mycompany\testtecnico\igu\StudentEdit$2.class", "Java", 0, 11, 0, 0, 0, 0, 11
"d:\Trabajos\PWC\Test-tecnico-Java\TestTecnico\target\classes\com\mycompany\testtecnico\igu\StudentEdit$3.class", "Java", 0, 11, 0, 0, 0, 0, 11
"d:\Trabajos\PWC\Test-tecnico-Java\TestTecnico\target\classes\com\mycompany\testtecnico\igu\StudentEdit$4.class", "Java", 0, 8, 0, 0, 0, 0, 8
"d:\Trabajos\PWC\Test-tecnico-Java\TestTecnico\target\classes\com\mycompany\testtecnico\igu\StudentEdit$5.class", "Java", 0, 11, 0, 0, 0, 0, 11
"d:\Trabajos\PWC\Test-tecnico-Java\TestTecnico\target\classes\com\mycompany\testtecnico\igu\StudentEdit$6.class", "Java", 0, 11, 0, 0, 0, 0, 11
"d:\Trabajos\PWC\Test-tecnico-Java\TestTecnico\target\classes\com\mycompany\testtecnico\igu\StudentEdit$7.class", "Java", 0, 11, 0, 0, 0, 0, 11
"d:\Trabajos\PWC\Test-tecnico-Java\TestTecnico\target\classes\com\mycompany\testtecnico\igu\StudentEdit.class", "Java", 0, 102, 0, 0, 6, 0, 108
"d:\Trabajos\PWC\Test-tecnico-Java\TestTecnico\target\classes\com\mycompany\testtecnico\igu\StudentPanel$1.class", "Java", 0, 8, 0, 0, 0, 0, 8
"d:\Trabajos\PWC\Test-tecnico-Java\TestTecnico\target\classes\com\mycompany\testtecnico\igu\StudentPanel$2.class", "Java", 0, 11, 0, 0, 0, 0, 11
"d:\Trabajos\PWC\Test-tecnico-Java\TestTecnico\target\classes\com\mycompany\testtecnico\igu\StudentPanel$3.class", "Java", 0, 11, 0, 0, 0, 0, 11
"d:\Trabajos\PWC\Test-tecnico-Java\TestTecnico\target\classes\com\mycompany\testtecnico\igu\StudentPanel$4.class", "Java", 0, 11, 0, 0, 0, 0, 11
"d:\Trabajos\PWC\Test-tecnico-Java\TestTecnico\target\classes\com\mycompany\testtecnico\igu\StudentPanel$5.class", "Java", 0, 11, 0, 0, 0, 0, 11
"d:\Trabajos\PWC\Test-tecnico-Java\TestTecnico\target\classes\com\mycompany\testtecnico\igu\StudentPanel$6.class", "Java", 0, 11, 0, 0, 0, 0, 11
"d:\Trabajos\PWC\Test-tecnico-Java\TestTecnico\target\classes\com\mycompany\testtecnico\igu\StudentPanel.class", "Java", 0, 110, 0, 0, 10, 0, 120
"d:\Trabajos\PWC\Test-tecnico-Java\TestTecnico\target\classes\com\mycompany\testtecnico\igu\TeacherEdit$1.class", "Java", 0, 11, 0, 0, 0, 0, 11
"d:\Trabajos\PWC\Test-tecnico-Java\TestTecnico\target\classes\com\mycompany\testtecnico\igu\TeacherEdit$2.class", "Java", 0, 11, 0, 0, 0, 0, 11
"d:\Trabajos\PWC\Test-tecnico-Java\TestTecnico\target\classes\com\mycompany\testtecnico\igu\TeacherEdit$3.class", "Java", 0, 11, 0, 0, 0, 0, 11
"d:\Trabajos\PWC\Test-tecnico-Java\TestTecnico\target\classes\com\mycompany\testtecnico\igu\TeacherEdit$4.class", "Java", 0, 11, 0, 0, 0, 0, 11
"d:\Trabajos\PWC\Test-tecnico-Java\TestTecnico\target\classes\com\mycompany\testtecnico\igu\TeacherEdit.class", "Java", 0, 95, 0, 0, 0, 0, 95
"d:\Trabajos\PWC\Test-tecnico-Java\TestTecnico\target\classes\com\mycompany\testtecnico\igu\TeacherPanel$1.class", "Java", 0, 8, 0, 0, 0, 0, 8
"d:\Trabajos\PWC\Test-tecnico-Java\TestTecnico\target\classes\com\mycompany\testtecnico\igu\TeacherPanel$2.class", "Java", 0, 11, 0, 0, 0, 0, 11
"d:\Trabajos\PWC\Test-tecnico-Java\TestTecnico\target\classes\com\mycompany\testtecnico\igu\TeacherPanel$3.class", "Java", 0, 11, 0, 0, 0, 0, 11
"d:\Trabajos\PWC\Test-tecnico-Java\TestTecnico\target\classes\com\mycompany\testtecnico\igu\TeacherPanel$4.class", "Java", 0, 11, 0, 0, 0, 0, 11
"d:\Trabajos\PWC\Test-tecnico-Java\TestTecnico\target\classes\com\mycompany\testtecnico\igu\TeacherPanel$5.class", "Java", 0, 11, 0, 0, 0, 0, 11
"d:\Trabajos\PWC\Test-tecnico-Java\TestTecnico\target\classes\com\mycompany\testtecnico\igu\TeacherPanel$6.class", "Java", 0, 11, 0, 0, 0, 0, 11
"d:\Trabajos\PWC\Test-tecnico-Java\TestTecnico\target\classes\com\mycompany\testtecnico\igu\TeacherPanel$7.class", "Java", 0, 11, 0, 0, 0, 0, 11
"d:\Trabajos\PWC\Test-tecnico-Java\TestTecnico\target\classes\com\mycompany\testtecnico\igu\TeacherPanel.class", "Java", 0, 110, 0, 0, 39, 0, 149
"d:\Trabajos\PWC\Test-tecnico-Java\TestTecnico\target\classes\com\mycompany\testtecnico\igu\WatchmanEdit$1.class", "Java", 0, 11, 0, 0, 0, 0, 11
"d:\Trabajos\PWC\Test-tecnico-Java\TestTecnico\target\classes\com\mycompany\testtecnico\igu\WatchmanEdit$2.class", "Java", 0, 11, 0, 0, 0, 0, 11
"d:\Trabajos\PWC\Test-tecnico-Java\TestTecnico\target\classes\com\mycompany\testtecnico\igu\WatchmanEdit$3.class", "Java", 0, 11, 0, 0, 0, 0, 11
"d:\Trabajos\PWC\Test-tecnico-Java\TestTecnico\target\classes\com\mycompany\testtecnico\igu\WatchmanEdit$4.class", "Java", 0, 11, 0, 0, 0, 0, 11
"d:\Trabajos\PWC\Test-tecnico-Java\TestTecnico\target\classes\com\mycompany\testtecnico\igu\WatchmanEdit.class", "Java", 0, 92, 0, 0, 0, 0, 92
"d:\Trabajos\PWC\Test-tecnico-Java\TestTecnico\target\classes\com\mycompany\testtecnico\igu\WatchmanPanel$1.class", "Java", 0, 8, 0, 0, 0, 0, 8
"d:\Trabajos\PWC\Test-tecnico-Java\TestTecnico\target\classes\com\mycompany\testtecnico\igu\WatchmanPanel$2.class", "Java", 0, 11, 0, 0, 0, 0, 11
"d:\Trabajos\PWC\Test-tecnico-Java\TestTecnico\target\classes\com\mycompany\testtecnico\igu\WatchmanPanel$3.class", "Java", 0, 11, 0, 0, 0, 0, 11
"d:\Trabajos\PWC\Test-tecnico-Java\TestTecnico\target\classes\com\mycompany\testtecnico\igu\WatchmanPanel$4.class", "Java", 0, 11, 0, 0, 0, 0, 11
"d:\Trabajos\PWC\Test-tecnico-Java\TestTecnico\target\classes\com\mycompany\testtecnico\igu\WatchmanPanel$5.class", "Java", 0, 11, 0, 0, 0, 0, 11
"d:\Trabajos\PWC\Test-tecnico-Java\TestTecnico\target\classes\com\mycompany\testtecnico\igu\WatchmanPanel$6.class", "Java", 0, 11, 0, 0, 0, 0, 11
"d:\Trabajos\PWC\Test-tecnico-Java\TestTecnico\target\classes\com\mycompany\testtecnico\igu\WatchmanPanel$7.class", "Java", 0, 11, 0, 0, 0, 0, 11
"d:\Trabajos\PWC\Test-tecnico-Java\TestTecnico\target\classes\com\mycompany\testtecnico\igu\WatchmanPanel$8.class", "Java", 0, 11, 0, 0, 0, 0, 11
"d:\Trabajos\PWC\Test-tecnico-Java\TestTecnico\target\classes\com\mycompany\testtecnico\igu\WatchmanPanel.class", "Java", 0, 110, 0, 0, 13, 0, 123
"d:\Trabajos\PWC\Test-tecnico-Java\TestTecnico\target\classes\com\mycompany\testtecnico\logic\CivilStatus.class", "Java", 0, 13, 0, 0, 0, 0, 13
"d:\Trabajos\PWC\Test-tecnico-Java\TestTecnico\target\classes\com\mycompany\testtecnico\logic\CivilStatus_.class", "Java", 0, 6, 0, 0, 0, 0, 6
"d:\Trabajos\PWC\Test-tecnico-Java\TestTecnico\target\classes\com\mycompany\testtecnico\logic\Controller.class", "Java", 0, 178, 0, 0, 0, 1, 179
"d:\Trabajos\PWC\Test-tecnico-Java\TestTecnico\target\classes\com\mycompany\testtecnico\logic\Course.class", "Java", 0, 13, 0, 0, 0, 0, 13
"d:\Trabajos\PWC\Test-tecnico-Java\TestTecnico\target\classes\com\mycompany\testtecnico\logic\CourseAndStudent.class", "Java", 0, 18, 0, 0, 0, 0, 18
"d:\Trabajos\PWC\Test-tecnico-Java\TestTecnico\target\classes\com\mycompany\testtecnico\logic\CourseAndStudent_.class", "Java", 0, 6, 0, 0, 0, 0, 6
"d:\Trabajos\PWC\Test-tecnico-Java\TestTecnico\target\classes\com\mycompany\testtecnico\logic\Course_.class", "Java", 0, 5, 0, 0, 0, 0, 5
"d:\Trabajos\PWC\Test-tecnico-Java\TestTecnico\target\classes\com\mycompany\testtecnico\logic\Department.class", "Java", 0, 22, 0, 0, 0, 0, 22
"d:\Trabajos\PWC\Test-tecnico-Java\TestTecnico\target\classes\com\mycompany\testtecnico\logic\Department_.class", "Java", 0, 5, 0, 0, 0, 0, 5
"d:\Trabajos\PWC\Test-tecnico-Java\TestTecnico\target\classes\com\mycompany\testtecnico\logic\Person.class", "Java", 0, 13, 0, 0, 0, 0, 13
"d:\Trabajos\PWC\Test-tecnico-Java\TestTecnico\target\classes\com\mycompany\testtecnico\logic\Person_.class", "Java", 0, 6, 0, 0, 0, 0, 6
"d:\Trabajos\PWC\Test-tecnico-Java\TestTecnico\target\classes\com\mycompany\testtecnico\logic\Section.class", "Java", 0, 23, 0, 0, 0, 0, 23
"d:\Trabajos\PWC\Test-tecnico-Java\TestTecnico\target\classes\com\mycompany\testtecnico\logic\Section_.class", "Java", 0, 7, 0, 0, 0, 0, 7
"d:\Trabajos\PWC\Test-tecnico-Java\TestTecnico\target\classes\com\mycompany\testtecnico\logic\Servicestaff.class", "Java", 0, 22, 0, 0, 0, 0, 22
"d:\Trabajos\PWC\Test-tecnico-Java\TestTecnico\target\classes\com\mycompany\testtecnico\logic\Servicestaff_.class", "Java", 0, 8, 0, 0, 0, 0, 8
"d:\Trabajos\PWC\Test-tecnico-Java\TestTecnico\target\classes\com\mycompany\testtecnico\logic\Staff.class", "Java", 0, 12, 0, 0, 0, 0, 12
"d:\Trabajos\PWC\Test-tecnico-Java\TestTecnico\target\classes\com\mycompany\testtecnico\logic\Staff_.class", "Java", 0, 6, 0, 0, 0, 0, 6
"d:\Trabajos\PWC\Test-tecnico-Java\TestTecnico\target\classes\com\mycompany\testtecnico\logic\Student.class", "Java", 0, 11, 0, 0, 0, 0, 11
"d:\Trabajos\PWC\Test-tecnico-Java\TestTecnico\target\classes\com\mycompany\testtecnico\logic\Student_.class", "Java", 0, 6, 0, 0, 0, 0, 6
"d:\Trabajos\PWC\Test-tecnico-Java\TestTecnico\target\classes\com\mycompany\testtecnico\logic\Teacher.class", "Java", 0, 26, 0, 0, 0, 0, 26
"d:\Trabajos\PWC\Test-tecnico-Java\TestTecnico\target\classes\com\mycompany\testtecnico\logic\Teacher_.class", "Java", 0, 10, 0, 0, 0, 0, 10
"d:\Trabajos\PWC\Test-tecnico-Java\TestTecnico\target\classes\com\mycompany\testtecnico\persistence\CourseController.class", "Java", 0, 41, 0, 0, 0, 0, 41
"d:\Trabajos\PWC\Test-tecnico-Java\TestTecnico\target\classes\com\mycompany\testtecnico\persistence\CoursesAndStudentsController.class", "Java", 0, 43, 0, 0, 0, 0, 43
"d:\Trabajos\PWC\Test-tecnico-Java\TestTecnico\target\classes\com\mycompany\testtecnico\persistence\DBConection.class", "Java", 0, 28, 0, 0, 0, 0, 28
"d:\Trabajos\PWC\Test-tecnico-Java\TestTecnico\target\classes\com\mycompany\testtecnico\persistence\DepartmentController.class", "Java", 0, 44, 0, 0, 0, 0, 44
"d:\Trabajos\PWC\Test-tecnico-Java\TestTecnico\target\classes\com\mycompany\testtecnico\persistence\PersistenceController.class", "Java", 0, 132, 0, 0, 0, 0, 132
"d:\Trabajos\PWC\Test-tecnico-Java\TestTecnico\target\classes\com\mycompany\testtecnico\persistence\PersistenceIdObjects.class", "Java", 0, 19, 0, 0, 24, 0, 43
"d:\Trabajos\PWC\Test-tecnico-Java\TestTecnico\target\classes\com\mycompany\testtecnico\persistence\PersistenceService.class", "Java", 0, 13, 0, 0, 1, 0, 14
"d:\Trabajos\PWC\Test-tecnico-Java\TestTecnico\target\classes\com\mycompany\testtecnico\persistence\SectionController.class", "Java", 0, 44, 0, 0, 0, 0, 44
"d:\Trabajos\PWC\Test-tecnico-Java\TestTecnico\target\classes\com\mycompany\testtecnico\persistence\ServicestaffController.class", "Java", 0, 124, 0, 0, 0, 0, 124
"d:\Trabajos\PWC\Test-tecnico-Java\TestTecnico\target\classes\com\mycompany\testtecnico\persistence\StaffController.class", "Java", 0, 5, 0, 0, 0, 0, 5
"d:\Trabajos\PWC\Test-tecnico-Java\TestTecnico\target\classes\com\mycompany\testtecnico\persistence\StudentController.class", "Java", 0, 38, 0, 0, 0, 0, 38
"d:\Trabajos\PWC\Test-tecnico-Java\TestTecnico\target\classes\com\mycompany\testtecnico\persistence\TeacherController.class", "Java", 0, 127, 0, 0, 0, 0, 127
"d:\Trabajos\PWC\Test-tecnico-Java\TestTecnico\target\classes\com\mycompany\testtecnico\persistence\exceptions\IllegalOrphanException.class", "Java", 0, 8, 0, 0, 0, 0, 8
"d:\Trabajos\PWC\Test-tecnico-Java\TestTecnico\target\classes\com\mycompany\testtecnico\persistence\exceptions\NonexistentEntityException.class", "Java", 0, 9, 0, 0, 0, 0, 9
"d:\Trabajos\PWC\Test-tecnico-Java\TestTecnico\target\classes\com\mycompany\testtecnico\persistence\exceptions\PreexistingEntityException.class", "Java", 0, 9, 0, 0, 0, 0, 9
"d:\Trabajos\PWC\Test-tecnico-Java\TestTecnico\target\generated-sources\annotations\com\mycompany\testtecnico\logic\CivilStatus_.java", "Java", 0, 13, 0, 0, 0, 4, 17
"d:\Trabajos\PWC\Test-tecnico-Java\TestTecnico\target\generated-sources\annotations\com\mycompany\testtecnico\logic\CourseAndStudent_.java", "Java", 0, 13, 0, 0, 0, 4, 17
"d:\Trabajos\PWC\Test-tecnico-Java\TestTecnico\target\generated-sources\annotations\com\mycompany\testtecnico\logic\Course_.java", "Java", 0, 10, 0, 0, 0, 4, 14
"d:\Trabajos\PWC\Test-tecnico-Java\TestTecnico\target\generated-sources\annotations\com\mycompany\testtecnico\logic\Department_.java", "Java", 0, 10, 0, 0, 0, 4, 14
"d:\Trabajos\PWC\Test-tecnico-Java\TestTecnico\target\generated-sources\annotations\com\mycompany\testtecnico\logic\Person_.java", "Java", 0, 12, 0, 0, 0, 4, 16
"d:\Trabajos\PWC\Test-tecnico-Java\TestTecnico\target\generated-sources\annotations\com\mycompany\testtecnico\logic\Section_.java", "Java", 0, 13, 0, 0, 0, 4, 17
"d:\Trabajos\PWC\Test-tecnico-Java\TestTecnico\target\generated-sources\annotations\com\mycompany\testtecnico\logic\Servicestaff_.java", "Java", 0, 12, 0, 0, 0, 4, 16
"d:\Trabajos\PWC\Test-tecnico-Java\TestTecnico\target\generated-sources\annotations\com\mycompany\testtecnico\logic\Staff_.java", "Java", 0, 11, 0, 0, 0, 4, 15
"d:\Trabajos\PWC\Test-tecnico-Java\TestTecnico\target\generated-sources\annotations\com\mycompany\testtecnico\logic\Student_.java", "Java", 0, 7, 0, 0, 0, 4, 11
"d:\Trabajos\PWC\Test-tecnico-Java\TestTecnico\target\generated-sources\annotations\com\mycompany\testtecnico\logic\Teacher_.java", "Java", 0, 12, 0, 0, 0, 4, 16
"d:\Trabajos\PWC\Test-tecnico-Java\test_tecnico.sql", "SQL", 0, 0, 0, 20, 12, 6, 38
"Total", "-", 50, 8679, 121, 20, 664, 1457, 10991